111111111
1P100C1E1
101010101
101010101
101010101
101010101
100010001
111111111