1111111111
10000CPE01
1111111111