1111111111
1PC00100E1
1001010001
1010010001
1000010001
1000010101
1010000001
1000100001
1111111111