111111111
1P0CCC0E1
1C0C0C0C1
1C0C0C0C1
100000001
1C0C0C0C1
1CCC0CCC1
111111111