11111111111111111
1P100000001E1CCC1
10CCCCCCCCC0CCCC1
11CCCCCCCCCCC1CC1
11111111111111111