11111111111111111
1P00000000CECCCC1
1CCCCCCCCCCCCCCC1
1CCCCCCCCCCCCCCC1
11111111111111110