1111111111
1C00100C01
1000P000E1
1111111111