111111111
1P1CCC1E1
1C1C1C1C1
1C1C1C1C1
101010101
1C1C1C1C1
1CCC1CCC1
111111111