1111111
1P10001
1001001
101C101
1C00111
1000CE1
1111111