1111111111
10C0PE0C01
1111111111
1000000001
1000000001
1111111111